</S>	EH S
<S>	EH S
AM	AE M
AM(2)	EY EH M
CHEAP	CH IY P
CHINESE	CH AY N IY Z
FOOD	F UW D
FOR	F AO R
FOR(2)	F ER
FOR(3)	F R ER
I	AY
IN	IH N
INDINA	IH N D IH N AH
INTERESTED	IH N T AH R EH S T IH D
ITALIAN	IH T AE L Y AH N
LOOKING	L UH K IH NG
ME.	M IY
NEAR	N IH R
RESTAURANT	R EH S T ER AA N T
RESTAURANT(2)	R EH S T R AA N T
RESTAURANT.	R EH S T AH R AA N T
